***************
***************
*****####******
*****#  ###****
*****#    #****
*****# $  #****
*****### ###***
*****# $ $ #***
*****#..@..#***
*****#  $  #***
*****###  ##***
*******####****
***************
***************
***************