***************
***************
****####*******
****#  ###*****
****#    #*****
****# $  #*****
****### ###****
****# $ $ #****
****#..@..#****
****#  $  #****
****###  ##****
*****#####*****
***************
***************
***************