***************
***************
***************
***########****
**##      ##***
**# .####  #***
**# .    # #***
**# ? $$ # #***
**# ?## #  #***
**# +   # ##***
**# $###  #****
**##     ##****
***#######*****
***************
***************