51
*****************
*****************
*****************
*******#####*****
****####   #*****
****#      #*****
****#  ##.##*****
****## #@  #*****
*****#..$  #*****
****## #$###*****
****#   $ #******
****# #   #******
****#   ###******
****#####********
*****************
*****************
*****************
