35
*****************
*****************
*****************
*****************
*****************
*****#######*****
****##  #  ##****
****#  ??$. #****
****#   #   #****
****##  ?  ##****
*****#  ? @#*****
*****#######*****
*****************
*****************
*****************
*****************
*****************