27
*****************
*****************
*****************
*****************
******####*******
******#  #*******
******#. ##******
******#$@ #******
*****## ? #******
*****#  ? #******
*****#  ? #******
*****## ? #******
******#  ##******
******####*******
*****************
*****************
*****************