37
*****************
*****************
*****************
*****************
*****######******
*****#  @ ##*****
****## #   #*****
****# .?.?.#*****
****#  $ $ #*****
****#####$ #*****
********#  #*****
********####*****
*****************
*****************
*****************
*****************
*****************