21
*****************
*****************
*****************
*****************
******#####******
******#   #******
*****##$# ###****
*****#   $@ #****
*****# #  # #****
*****# #. . #****
*****#   ####****
*****#####*******
*****************
*****************
*****************
*****************
*****************
