*****************
*****************
*****************
*****#######*****
*****#  @  #*****
*****# ### ##****
####*# #*#  #####
#  ### #*# .    #
# .    #*# ? $$ #
# ? $$ #*# ?## ##
# ?## ##*# ?   #*
# .   #**# ?## #*
#  ####**# .   #*
####*****#  ####*
*********####****
*****************
*****************
