29
*****************
*****************
*****************
*****************
*****#######*****
****##  @  ##****
****#  ###  #****
****# # . # #****
****# #$. $ #****
****# $   ###****
****###$. #******
******# . #******
******#####******
*****************
*****************
*****************
*****************