61
*****************
*****************
*****************
*****************
*********####****
*****#####  #****
*****#   ?  #****
*****# ?.#  #****
*****## ## ##****
*****# $    #****
*****# @#   #****
*****#  #####****
*****####********
*****************
*****************
*****************
*****************