*****************
*****************
*****************
*****************
********######***
#######*#    ##**
#     ### ##  ##*
# #  $.##$  #  ##
#  #  ?.@.?  #  #
##  #  $##.$  # #
*##  ## ###     #
**##    #*#######
***######********
*****************
*****************
*****************
*****************