*******#####*****
*******#   #*****
******## # #*****
******# ?  #*****
******# # ##*****
####### #  #*****
#   # .$.$.####**
# #   $$.$$   ###
#  ?##..@..##?  #
###   $$.$$   # #
**####.$.$. #   #
*****#  # #######
*****## # #******
*****#  ? #******
*****# # ##******
*****#   #*******
*****#####*******