*****************
*****************
*****************
##############*** 
#      #  #  ####
# #### #  @   . #
# $.....  #  #$ #
##$#####  # ##. #
*#      ###   $ #
*# ##$   ## ##  #
## ###$     #####
# $  #  #####****
#    ####********
###  #***********
**####***********
*****************
*****************