*****************
*****************
**#############**
**#     #     #**
**# # #   # # #**
**#  .$.$.$.  #**
**# #$.$.$.$# #**
**#  .$.$.$.  #**
**# #$.$@$.$# #**
**#  .$.$.$.  #**
**# #$.$.$.$# #**
**#  .$.$.$.  #**
**# # # # # # #**
**#     #     #**
**#############**
*****************
*****************

