43
*****************
*****************
*****************
*****************
****####*********
****#  ####******
****#     #******
****#     #******
****### ###******
****# $$$ ##*****
****# ...@ #*****
****####   #*****
*******#####*****
*****************
*****************
*****************
*****************