37
*****************
*****************
*****************
*****************
*********####****
***#######  #****
***#        #****
***#  $ #.# #****
***#  $## # ##***
***###   @   #***
*****###  #  #***
*******##.  ##***
********#####****
*****************
*****************
*****************
*****************