*****************
*****************
***####*#*####***
**##  #***#  ##**
**#   #####   #**
**#  $. ? .$  #**
**###.$.$.$.###**
****# .$ $. #****
**#*#?$ @ $?#*#**
****# .$ $. #****
**###.$.$.$.###**
**#  $. ? .$  #**
**#   #####   #**
**##  #***#  ##**
***####*#*####***
*****************
*****************