70
*****************
*****************
*****************
*****************
*********####****
***#######  #****
***#        #****
***#  $ #.# #****
***# $$## # ##***
***### . @   #***
*****###  #  #***
*******##.  ##***
********#####****
*****************
*****************
*****************
*****************