*****************
***############**
**#      @     #*
*# #  $ ## $  # #
*#  #.##  ##.#  #
*#  .   ##   .  #
*# $# #?##?# #$ #
*#  # ?    ? #  #
*# # ## ?  ## # #
*# # ##  ? ## # #
*#  # ?    ? #  #
*# $# #?##?# #$ #
*#  .   ##   .  #
*#  #.##  ##.#  #
*# #  $ ## $  # #
**#            #*
***############**
