10
*****************
*****************
*****************
*****************
*****#####*******
*****#...#*******
*****##$ #*******
*****##@ ##******
*****# $$ #******
*****#   ##******
*****#  ##*******
*****#####*******
*****************
*****************
*****************
*****************
*****************