****#########****
****#       #****
**###$#$ $#$###**
**# . . . . . #**
###$#$#$ $#$#$###
# . . . . . . . #
# #$#$#$#$#$#$# #
# . . .   . . . #
###$#$##@##$#$###
# . . .   . . . #
# #$#$#$#$#$#$# #
# . . . . . . . #
###$#$#$ $#$#$###
**# . . . . . #**
**###$#$ $#$###**
****#       #****
****#########****