6
*****************
*****************
*****************
*****************
*****########****
*****#  #   #****
*****#    . #****
*****#      #****
*****#    ###****
*****#      #****
*****#  $   #****
*****# @ #  #****
*****########****
*****************
*****************
*****************
*****************