***************
***************
***************
***************
****#####******
****#  @####***
****#  $.  #***
****###$.# #***
****#  $.# #***
****# #$.  #***
****#    ###***
****######*****
***************
***************
***************