*****************
*****************
*****************
*****************
*****#####*******
*****#...#*******
******#$ #*******
******#@ ##******
*****# $$ #******
*****#   ##******
*****#  ##*******
*****#####*******
*****************
*****************
*****************
*****************
*****************