57
*****************
*****************
*****************
*****************
****########*****
****#   #  #*****
****#      #*****
****## #. .#*****
****#    ###*****
****# # ? #******
****# $$# #******
****###  @#******
******#####******
*****************
*****************
*****************
*****************
