16
*****************
*****************
*****************
*****************
*****#####*******
*****#   ##******
*****# #  ##*****
*****#. #$ #*****
*****#  @  #*****
*****#.##$##*****
*****#    #******
*****######******
*****************
*****************
*****************
*****************
*****************