24
*****************
*****************
*****************
*****************
*****####********
*****#  ###******
*****#    ##*****
*****# .#$ #*****
*****## @  #*****
******#.#$##*****
******#   #******
******#####******
*****************
*****************
*****************
*****************
*****************