21
*****************
*****************
*****************
*****************
*****************
*****#######*****
*****#  #  ##****
****## ??$. #****
****#   #   #****
****#   @ ###****
****#  ####******
****####*********
*****************
*****************
*****************
*****************
*****************