21
*****************
*****************
*****************
*****************
*****************
*****#######*****
****##  #  #*****
****#  ??$.##****
****#   #   #****
****### @   #****
******####  #****
*********####****
*****************
*****************
*****************
*****************
*****************