16
*****************
*****************
*****************
*****************
*****************
******####*******
****###  ###*****
****#   ?$ #*****
****# #  #@#*****
****# # ?. #*****
****#   ####*****
****#####********
*****************
*****************
*****************
*****************
*****************