26
*****************
*****************
*****************
*****************
*****#####*******
*****#   ##******
*****# #  ###****
*****#   ?$ #****
*****###  #@#****
*******# ?. #****
*******#  ###****
*******####******
*****************
*****************
*****************
*****************
*****************