***************
***************
***************
******#####****
******#   #****
***#### # #****
***# . .# #****
***#  .   #****
***# .## $##***
***##  #$$ #***
****##   $@#***
*****##  ###***
******####*****