*****************
*****************
*****************
*******#####*****
*******#   #*****
****#### # #*****
****# . .# #*****
****#  .   #*****
****# .## $##****
****##  #$$ #****
*****##   $@#****
******##  ###****
*******####******
*****************
*****************