20
*****************
*****************
*****************
*****************
*******####******
******##  #******
*****##   ##*****
*****#  ?$ #*****
*****# # #@#*****
*****#  ?. #*****
*****###  ##*****
*******#  #******
*******####******
*****************
*****************
*****************
*****************