9
*****************
*****************
*****************
******####*******
******#. ###*****
******#$   #*****
******#    #*****
******#  $.##****
******#     #****
******#  @ .#****
******#  $  #****
******###  ##****
********####*****
*****************
*****************
*****************
*****************