17
*****************
*****************
*****************
*****************
*****************
******####*******
******#  ###*****
*****## .  #*****
****##@$$$ #*****
****# . . ##*****
****#   ###******
****#  ##********
****####*********
*****************
*****************
*****************
*****************