19
*****************
*****************
*****************
*****************
*******####******
******##  #******
*****## . ##*****
*****#@$$$ #*****
*****#. .# #*****
*****# #   #*****
*****#   ###*****
*****#####*******
*****************
*****************
*****************
*****************
*****************