21
*****************
*****************
*****************
*****************
*****************
*****#####*******
*****#   ##******
****## ? .##*****
****# $$?  #*****
****#  ? . #*****
****## @ ###*****
*****#####*******
*****************
*****************
*****************
*****************
*****************