43
*****************
*****************
*****************
*****************
********####*****
*****####  #*****
****## $   #*****
****#  # #$#*****
****#.@..  ##****
****## # #  #****
*****#   $  #****
*****#  #####****
*****####********
*****************
*****************
*****************
*****************