23
*****************
*****************
*****************
*****************
*****######******
*****#    #******
*****# ##$###****
*****# . ?  #****
*****##  ? @#****
******#  $  #****
******# #?###****
******#   #******
******#####****** 
*****************
*****************
*****************
*****************