20
*****************
*****************
*****************
*****************
******#####******
******#   #******
*****##$# ###****
*****#  .$@ #****
*****# #  # #****
*****# #..$ #****
*****#   ####****
*****#####*******
*****************
*****************
*****************
*****************
*****************
