***************
***************
***************
***####*####***
***#  ###  #***
***#  # $$ #***
***# $$ #  #***
***#    #  ##**
***###  .   #**
*****#..?.@.#**
*****##   ###**
******#####****
***************
***************
***************