*****************
*****************
*****************
*****************
****####*####****
****#  ###  #****
****#  # $$ #****
****# $$ #  #****
****#    #  ##***
****### $.#  #***
******#..?.@.#***
******##   ###***
*******#####*****
*****************
*****************
*****************
*****************