26
*****************
*****************
*****************
*****************
*****************
*****#####*******
****##   ###*****
****# . . .#*****
****# # ## ##****
****#    $$@#****
****### # $ #****
******#   ###****
******#####******
*****************
*****************
*****************
*****************