11
*****************
*****************
*****************
*****************
*****************
******######*****
*****##  . #*****
****#. $ # #*****
****#$ .$  #*****
****#   #$##*****
*****#. @ #******
*****#######*****
*****************
*****************
*****************
*****************
*****************