35
*****************
*****************
*****************
*****************
*******####******
****####  #******
****# $ $ #******
****#  .# ##*****
****## #.  #*****
****# @  $ #*****
****#.  ####*****
****#####********
*****************
*****************
*****************
*****************
*****************
