25
*****************
*****************
*****************
*****************
****####*********
****#  ####******
****#     #******
****#     #******
****### ###******
****# $$  ##*****
****# . .@ #*****
****####   #*****
*******#####*****
*****************
*****************
*****************
*****************