39
*****************
*****************
*****************
******####*******
******#  ###*****
******#    #*****
******# $  #*****
******### ###****
******# $ $ #****
******#..@..#****
******#  $  #****
******###  ##****
********####*****
*****************
*****************
*****************
*****************