24
*****************
*****************
*****************
*****************
*******####******
****####  #******
****# $   #******
****#  .# ##*****
****## #.  #*****
****# @  $ #*****
****#   ####*****
****#####********
*****************
*****************
*****************
*****************
*****************
