*****************
*****************
*****************
*****************
***######*####***
***#    ###  #***
***# ?     ? #***
***## #???#  #***
****#  ?+?   #***
***## #?$?#  #***
***#  # # #  #***
***#         #***
***#  ########***
***####**********
*****************
*****************
*****************
