***************
***************
***************
**######*####**
**#    ###  #**
**# ?     ? #**
**## #???#  #**
***#  ?+?   #**
**## #?$?#  #**
**#  # # #  #**
**#         #**
**#  ########**
**####*********
***************
***************
