12
*****************
*****************
*****************
*****************
*********####****
*****#####  #****
*****#   $  #****
*****#  .#  #****
*****## ## ##****
*****#      #****
*****# @#   #****
*****#  #####****
*****####********
*****************
*****************
*****************
*****************