22
*****************
*****************
*****************
*****************
*****************
*****#####*******
*****#  @####****
*****#  $.  #****
*****###$.# #****
*****#  $.# #****
*****# #$.  #****
*****#    ###****
*****######******
*****************
*****************
*****************
*****************