111
*****************
*****************
***********####**
***#########  #**
***#          #**
***# #?### #  #**
***#  $   # # #**
***#?#?##  #  #**
***#  $  #  # #**
***#  ?#  # # #**
***#  $ # # # ##*
***###$. . . . #*
*****#@####### #*
*****#         #*
*****###########*
*****************
*****************