3
*****************
*****************
*****************
*****************
*****************
******#####******
******#   #******
*****##   #******
*****# $ ##******
*****# @ .#******
*****######******
*****************
*****************
*****************
*****************
*****************
*****************
