***************
***************
***************
****########***
***##  . . #***
***# ?$# # #***
***#.  #$# ##**
**##? #  #  #**
**#   # ?   #**
**# $#@ .#  #**
**#     $ ###**
**##  #   #****
***########****
***************
***************
