23
*****************
*****************
*****************
****#########****
***##       ##***
***# .#####  #***
***# .     # #***
***# ? $$  # #***
***# ?## ##  #***
***# ?   #  ##***
***# ?## # ##****
***# +   # #*****
***# $###  #*****
***##     ##*****
****#######******
*****************
*****************