22
*****************
*****************
*****************
*****************
*****************
*****######******
****##    ##*****
****# $ $$ #*****
****#......#*****
****# $$ $ #*****
****### @###*****
******####*******
*****************
*****************
*****************
*****************
*****************