63
*****************
*****************
*****************
*****************
*****########****
****##  . . #****
****# ?$# # #****
****#.  #$# ##***
***##? #  #  #***
***#   # ?   #***
***# $#@ .#  #***
***#     $ ###***
***##  #   #*****
****########*****
*****************
*****************
*****************
