***************
***************
***************
****####*******
****#  #*******
****#$ #*******
****#  #*####**
*#### ####  #**
*#   .. ..  #**
*#  $?. ?.$@##*
*#   #$ $#$  #*
*#####   #   #*
*****#########*
***************
***************
