10
*****************
*****************
*****************
*****************
*******#####*****
*****###   #*****
*****# $ # ##****
*****# #  . #****
*****#    # #****
*****##$#.  #****
******#@  ###****
******#####******
*****************
*****************
*****************
*****************
*****************