105
*****************
*****************
*****************
*****************
****###########**
***##     #  @#**
**### $ $$#   #**
**# ##$    $$ #**
**#  #  $ #   #**
**###### ######**
**#.. ..$ #*##***
**# ..    ###****
**#  ..#####*****
**#########******
*****************
*****************
*****************
