21
*****************
*****************
*****************
******#######****
******#     ##***
**##### ###  ##**
**#       #  ##**
**#@$???. ##$ #**
**#  #    ## .#**
**##  ##  # $ #**
***##  ####.$.#**
****##        #**
*****######  ##**
**********####***
*****************
*****************
*****************
