42
*****************
*****************
*****************
*****************
****#########****
****#. .    #****
****#.$. .  #****
****## ###@ #****
*****#  $  ##****
*****# $$ ##*****
*****#  $ #******
*****#  ###******
*****####********
*****************
*****************
*****************
*****************
