*****************
*****************
*****************
*****************
******####*******
****###  ####****
****#   @   ##***
****# #. .#.###**
****# $$$ $$$ #**
****###.#.#.# #**
*****##       #**
******####  ###**
*********####****
*****************
*****************
*****************
*****************