***************
***************
***####********
***#  #********
***#$ #********
***#  #*####***
*### ####  #***
*#  .. ..  ###*
*# $?. ?.$@  #*
*## #$ $#$ # #*
**# #   #  # #*
**#  ######  #*
**##        ##*
***##########**
***************

