58
*****************
*****************
*****#######*****
***###     ##****
***#   ###  #****
***#      # #****
**###$#@  # #****
**#   ##### #****
**#   #  ?. #****
**##$$#  ?.##****
***#     ?..#****
***#### #...##***
******# #$$$ #***
******#   $  #***
******#####  #***
**********####***
*****************