94
*****************
*****************
***### ### ###***
**##  # @ #  ##**
**#  $#$ $#$  #**
**# . . . . . #**
***##$#$ $#$##***
**# . . . . . #**
**#  $ $#$ $  #**
**# . . . . . #**
***##$#$ $#$##***
**# . . . . . #**
**#  $#$ $#$  #**
**##  #   #  ##**
***### ### ###***
*****************
*****************