222
*****************
****###   ###****
****#  ###  #****
***#    #    #***
*##  $$$.$$$  ##*
*#  .# . . #.  #*
*#  . # $ # .  #*
**# .$ #.# $. #**
**##$ .$@$. $##**
**# .$ #.# $. #**
*#  . # $ # .  #*
*#  .# . . #.  #*
*##  $$$.$$$  ##*
***#    #    #***
****#  ###  #****
****###   ###****
*****************

