194
*****************
**####*###*####**
*#    #   #    #*
*# #  #   #  # #*
*#  ??$???$??  #*
*#  ? .   . ?  #*
**##$.## ##.$##**
*#  ? #   # ?  #*
*#  ?   @   ?  #*
*#  ? #   # ?  #*
**##$.## ##.$##**
*#  ? .   . ?  #*
*#  ??$???$??  #*
*# #  #   #  # #*
*#    #   #    #*
**####*###*####**
*****************
