170
#*####**#**####*#
*#    #   #    #*
# ?.   ###   .? #
# $# $ $ $ $ #$ #
#   # .? ?. #   #
#  . #  $  # .  #
*#  $ ##$## $  #*
**#.? # . # ?.#**
#*#  ..$@$..  #*#
**#.? # . # ?.#**
*#  $ ##$## $  #*
#  . #  $  # .  #
#   # .? ?. #   #
# $# $ $ $ $ #$ #
# ?.   ###   .? #
*#    #   #    #*
#*####**#**####*#

