58
*****************
*****************
*****************
*****######******
*****#    #####**
*****# $ ?#   #**
*****#  ? ? $ #**
****###? . ?  #**
****# ? .@. ? #**
****#  ? . ?###**
****# $ ? ?  #***
****#   #? $ #***
****#####    #***
********######***
*****************
*****************
*****************