36
*****************
*****************
*****************
*****************
****#########****
****#   ?   #****
****# ## ## #****
****#  ? ?  #****
***###  #  ###***
***#  .$#$.  #***
***# #  @  # #***
***#  .$#$.  #***
***###  #  ###***
*****#######*****
*****************
*****************
*****************