***************
***************
*****####******
*****#  ###****
*****#    #****
*****#    #****
*****### ###***
*****#     #***
*****#  @ .#***
*****#  $  #***
*****###  ##***
*******####****
***************
***************
***************