*****************
*****************
*****************
******####*******
******#  ###*****
******#    #*****
******#    #*****
******### ###****
******#     #****
******#  @ .#****
******#  $  #****
******###  ##****
********####*****
*****************
*****************
*****************
*****************