84
*****************
*****************
*****************
***********####**
****########@ #**
****#   ...#$ #**
****# $ $ $ ? #**
****#####   . #**
*******##$#$. #**
*****###. # .##**
*****#  .$#$ #***
*****#  .$   #***
*****###.$#  #***
*******#  ####***
*******####******
*****************
*****************
