81
*****************
*****************
*****************
*****************
**###########****
*##         #****
*#  #######$##***
*# #       $ ###*
*# #...???.?.@ #*
*# #       $ # #*
*#  #######$#  #*
*##        $  ##*
**########   ##**
**********#####**
*****************
*****************
*****************