111
*****************
*****************
**********#******
***###########***
***#   #  #  #***
***# $ #$ $  #***
***#$.?.?.#? #***
***# .    $. #***
***#$.$#.  .$#***
**## .$   #? ##**
**#  .#.?##.  #**
**# $ $   $   #**
**### # # #####**
****##@   #******
*****######******
*****************
*****************
