52
*****************
*****************
*****************
***********#*****
****#*****# #****
***# #**##   ##**
**# . # # .$. #**
*# $.$ # .$ $. #*
#   ?  @ $ ? $  #
*# $.$ # .$ $. #*
**# . #*# .$. #**
***# #**##   ##**
****#*****# #****
***********#*****
*****************
*****************
*****************