62
*****************
*****########****
*****#  . . #****
*****# $.$. #****
*****##$#$# ##***
******# . .  #***
******#$#$# @#***
******# . .  #***
*****##$#$# ##***
*****#  . . #****
*****# $#$# ###**
*****##   . . #**
******###$#$# #**
********# .   #**
********#$# ###**
********#   #****
********#####****