36
*****************
*****************
*****************
****#########****
***##   ?   ##***
***#  # # #  #***
***# #.$.$.# #***
***#  $.$.$  #***
***#?#.$@$.#?#***
***#  $.$.$  #***
***# #.$.$.# #***
***#  # # #  #***
***##   ?   ##***
****#########****
*****************
*****************
*****************
